&&&&&&&&&&&&&&&&&&&&
&&&&&&&&&&&&&&&&&&&&
&       ***        &
&     **   **      &
&   **    @ #**    &
&  *     +   + *   &
&  *     #     *   &
&   **       **    &
&     **   **      &
&       ***        &
&&&&&&&&&&&&&&&&&&&&
