&&&&&*********&&&&&&
&&&&&*#     #*&&&&&&
&&&&&* *   * *&&&&&&
&&&&&*   +   *&&&&&&
&&&&&*  +@+  *&&&&&&
&&&&&*   +   *&&&&&&
&&&&&* *   * *&&&&&&
&&&&&*#     #*&&&&&&
&&&&&*********&&&&&&
&&&&&&&&&&&&&&&&&&&&
