********************
*     #            *
*           #      *
*        *         *
*        @         *
*        +         *
*        #     *****
*               +  *
*         +        *
*                # *
********************
