********************
*     #            *
*                  *
*                  *
*        @         *
*        #         *
*              *****
*               +  *
*         +        *
*                # *
********************
