********************
*                  *
*                  *
*         @        *
*          +#      *
*                  *
*                  *
*                  *
*                  *
*                  *
********************
