********************
*                  *
*                  *
*         @        *
*       #+*+#      *
*         *        *
*                  *
*                  *
*                  *
*                  *
********************
