&&&&&&&&&&&&&&&&&&&&
&&&&&&&&&*****&&&&&&
&&&&&&&&**   ****&&&
&&&&&&&&* +*   #*&&&
&&&&*****+ # *  *&&&
&&&&* +     **%+*&&&
&&&&*   *%%#%# @*&&&
&&&&*****    ****&&&
&&&&&&&&******&&&&&&
&&&&&&&&&&&&&&&&&&&&
