********************
*  @  #            *
*                  *
*        #         *
*                  *
*                  *
*   +              *
*                  *
*         +        *
********************
