&&&&&&&&&&&&&&&&&&&&
&&&&&&********&&&&&&
&&&&&&**@ ****&&&&&&
&&&&&&**++   *&&&&&&
&&&&&&*  + * *&&&&&&
&&&&&&* * ###*&&&&&&
&&&&&&*   ****&&&&&&
&&&&&&********&&&&&&
&&&&&&&&&&&&&&&&&&&&
&&&&&&&&&&&&&&&&&&&&
