&&&&&&&&&&&&&&&&&&&&
&&&&&&********&&&&&&
&&&&&&*@   +#*&&&&&&
&&&&&&*    + *&&&&&&
&&&&&&*****  *&&&&&&
&&&&&&*   * #*&&&&&&
&&&&&&*  + +#*&&&&&&
&&&&&&***** #*&&&&&&
&&&&&&&&&&****&&&&&&
&&&&&&&&&&&&&&&&&&&&
