&&&&&&&&&&&&&&&&&&&&
&&&&&&&&*****&&&&&&&
&&&&&**** ##*&&&&&&&
&&&&&*@ *+ #*&&&&&&&
&&&&&*  *  #*&&&&&&&
&&&&&*  + +**&&&&&&&
&&&&&*  +  *&&&&&&&&
&&&&&**  ***&&&&&&&&
&&&&&&****&&&&&&&&&&
&&&&&&&&&&&&&&&&&&&&
