&&&&&&&&&&&&&&&&&&&&
&&&&&&&&&*****&&&&&&
&&&&&&&***# #*&&&&&&
&&&&&&&*@+   *&&&&&&
&&&&&&**+*#  *&&&&&&
&&&&&&*# **+**&&&&&&
&&&&&&*  +   *&&&&&&
&&&&&&*  *   *&&&&&&
&&&&&&********&&&&&&
&&&&&&&&&&&&&&&&&&&&
