&&&&&&&&&&&&&&&&&&&&
&&&&&&&&*****&&&&&&&
&&&&&&***   *&&&&&&&
&&&&&&* + * **&&&&&&
&&&&&&* *  # *&&&&&&
&&&&&&*    * *&&&&&&
&&&&&&**+*#  *&&&&&&
&&&&&&&*@  ***&&&&&&
&&&&&&&*****&&&&&&&&
&&&&&&&&&&&&&&&&&&&&
