&&&&&&********&&&&&&
&&&&&&*@     *&&&&&&
&&&&&&*   ++ *&&&&&&
&&&&&&**  *  *&&&&&&
&&&&&&*  # +**&&&&&&
&&&&&&* *#  *&&&&&&&
&&&&&&*#  #+*&&&&&&&
&&&&&&****  *&&&&&&&
&&&&&&&&&*  *&&&&&&&
&&&&&&&&&****&&&&&&&
