&&&&&&&&********&&&&
&&&&&&&&*     @*&&&&
&&&&&&&&* +*+ **&&&&
&&&&&&&&* +  +*&&&&&
&&&&&&&&**+ + *&&&&&
********* + * ***&&&
*####  ** +  +  *&&&
**###    +  +   *&&&
*####  **********&&&
********&&&&&&&&&&&&
