&&&&&&&&&&&&&&&&&&&&
&&&&&&&****&&&&&&&&&
&&&&&&&*  ****&&&&&&
&&&&&&&* +@# *&&&&&&
&&&&&&** +   *&&&&&&
&&&&&&* + ****&&&&&&
&&&&&&*#  *&&&&&&&&&
&&&&&&*#+#*&&&&&&&&&
&&&&&&*****&&&&&&&&&
&&&&&&&&&&&&&&&&&&&&
